oooooooooooooooooooo
o------------------o
o----e--------e----o
o-----e------e-----o
o------e----e------o
o------------------o
oxxxx----------xxxxo
o------------------o
o------------------o
o--e------------e--o
o------------------o
o------------------o
oxxxx----------xxxxo
o------------------o
o------------------o
o------e----e------o
o-----e------e-----o
o----e--------e----o
o------------------o
oooooooooooooooooooo
