oooooooooooooooooooo
o------------------o
o----xxxxxxxxxx----o
o------------------o
o------e----e------o
o-e-------------e--o
o------------------o
o---x----------x---o
o---x----------x---o
o---x----------x---o
o---x----------x---o
o---x----------x---o
o------------------o
o--e-------------e-o
o------------------o
o------e----e------o
o------------------o
o----xxxxxxxxxx----o
o------------------o
oooooooooooooooooooo