oooooooooooooooooooo
o------------------o
o----e-------------o
o------------------o
o------------------o
oeee---------------o
o------------------o
o------------------o
o------------------o
o---------p--------o
o------------------o
o------------------o
o------------------o
o------------------o
o------------------o
o------------------o
o------------------o
o----e-------------o
o------------------o
oooooooooooooooooooo
